###############################
#p     ** *  1 * 2 *  * * *   #
# # # #*# # #*#*# # # #*#*#*# #
#  x*     f**  *  1   * 2 * * #
# # # # # #*# # #*#*# # # # #*#
#          x **  *  *   1     #
# # # # # # # # # #*# #*# # # #
#*  *      o  *      *        #
# # # # #*# # # #*#*# # # # # #
#*    **  *       *           #
# #*# # # # # # #*# # # # # # #
#           *   *  *          #
###############################