###############################
#p    * **    *   3   4       #
# # # #*# # # # # # # # # # # #
#      ** * *  *   * ** 3 *   #
#s# # # #f#*# # # # # # #*# # #
#*   * *   x*** *   **        #
# # # # # # # # # # #w# # #*# #
#   o*     *        *    **  3#
# #*# # #*#*#*#*# # #1# # #*# #
#        * 4 *2*    *   *     #
#*# # # # # # # # # # #*# # #*#
#**    * **    ** ***     1   #
###############################