###############################
#p * *2       *  ** * *      *#
# # # # #*# # #*# # # # # #*# #
#    * * *** **      *    **  #
# ## b# # # #1# #*#1# # # # #*#
#          *     **      *  **#
# # #*# # # # #3#*#*#*#*# # # #
#   *        *   * *** *      #
# # # # #*#x# # # # # #*# #*# #
#   ****         *1           #
#f# # # # # # # # #*# # # # #*#
#  ** *   *    2              #
###############################