###############################
#p     ** *  1 * 2 *  * * *   #
# # # #*# # #*#*# # # #*#*#*# #
#   *     ***  *  1   *   * * #
# # # # # #*# # #*#*# # # # #*#
#            **  *  *   1     #
#f# # # # # # # # #*# #*# # # #
#*  *      * x*      *        #
# # # #w#*# # # #*#*# # # # # #
#*    **  *       *           #
# #*# # # # # # #*# # # # # # #
#           *   *  *          #
###############################