###############################
#p * *3       *  ** * *      *#
# # # # #*# # #*# # #o# # #*# #
#    * * *** **  5   *    **  #
# #*#b# # # #4# #*#1# # # # #*#
#          *   x **      *  **#
# # #*# # # # # #*#*#*#*# # # #
#   *  f     *   * *** *   4  #
# # # # #*# # # # # # #*# #*# #
# s ****   w     *2           #
# # # # # #f# # # #*# # # # #*#
#  ** *5  *    2              #
###############################