###############################
#p     x* *    *   *  * * *   #
# # # #*# # #*#*# # # #*#*#*# #
#   *     ***  *      *   * * #
#f#s#b#o#w#*# # #*#*# # # # #*#
#            **  *  *         #
# # # # # # # # # #*# #*# # # #
#*  *      *  *      *        #
# # # # #*# # # #*#*# # # # # #
#*    **  *       *           #
# #*# # # # # # #*# # # # # # #
#           *   *  *          #
###############################